NO ./config/res/greystone.xpm
SO ./config/res/bluestone.xpm
WE ./config/res/mossy.xpm
EA ./config/res/wood.xpm
F 96,96,96
C 75,190,255
11111111111111111111111111111111111111111111111111
10000001000000000000000000000000000000000000000001
10000000000001000000000000000000000000000000000001
10000001000001000000000000000000000000000000000001
10000001000000000010000000000000000000000000000001
10000001000000000000000000000000000000000000000001
101001010000000000000000000000S0000000000000000001
10000001000000000000000000000000000000000000000001
10000001000000000000000000000000000000000000000001
11111111111111111111111111111111111111111111111111