NO ./config/path_to_the_north_texture
SO ./path_to_the_south_texture
WE ./path_to_the_west_texture
EA ./path_to_the_east_texture
F 96,96,96
C 75,190,255
11111111111111111111111111111111111111111111111111
10000000000000000000000000000000000000000000000001
10000000000001000000000000000000000000000000000001
10000001000001000000000000000000000000000000000001
10000001000000000010000000000000000000000000000001
10000001000000000000000000000000000000000000000001
1010010100000000N000000000000000000000000000000001
10000001000000000000000000000000000000000000000001
10000001000000000000000000000000000000000000000001
11111111111111111111111111111111111111111111111111